W                                                               W
W                                                               W
W                                                               W
W                                                               W
W                                                               W
W                                                               W
W                                                               W
W                                                               W
W                                                               W
W                                                               W
W                                                               W
W                                                               W
W                                                               W
W                                                               W
W  J                                                            W
W                                                          D    W
W  N                                                            W
WFFFFFLLLLLLLLFFFFFFFFFFFFFFFFFFFFFFFFFFFFFFFFFFFFFFFFFFFFFFFFFFW