W          W
W          W
W          W
W          W
W          W
W          W
W          W
W          W
WN       D W
W          W
WFFFFFFFFFFW
W          W
W          W
WJ       D W
W          W
WFFFFFFFFFFW